111111111111111111111111111111111111
111111111111111111111111111111111111
111110000001111000000110000000001111
110001111000000000110000011001100011
110000000000001100000000000000000011
110000000000000011011111111000000011
110000110111100000012111211001100011
110000000121100110000000000000000011
110001100000000001100000000000000011
110000011000000000000000000011000011
110000000000000000000000000000110011
110000000000000000000000000000000011
110110000000000000000000000000000011
1100000000.0000000000000000000111111
110000000000001111000000000000111111
110011000000001211000000000000000011
110000000000000000000000000000000011
110000001100000000000000000000000011
110000000000000000000000000000000011
111111111111111111111111111111111111
111111111111111111111111111111111111