Z111111111111111111111111111111111111
1111100000011110000001100000000011111
1100011110000000001100000110011000111
1000000000000011000000000000000000111
1100000000000000110111111110000000111
1000001101111000000121112110011000111
1100000001211001100000000000000000111
1000011000000000011000000000000000111
1100000110000000000000000000110000111
1000000000000000000000000000001100111
1100000000000000000000000000000000111
1001100000000000000000000000000000111
1100000000A00000000000000000001111111
1000000000000011110000000000001111111
1100110000000012110000000000000000111
1000000000000000000000000000000000111
1100000011000000000000000000000000111
1000000000000000000000000000000000111
1100000000000000000000000000000000111
1111111111111111111111111111111111111
1111111111111111111111111111111111111