11111111111111111111111111111111111111111111111111
11111111111111111111111111111111111111111111111111
11111111111111111111111111111111111111111111111111
11111111111100000011110000001100000000011111111111
11111111100011110000000001100000110011000111111111
11111111100000000000011000000000000000000111111111
11111111100000000000000110111111110000000111111111
11111111100001101111000000121112110011000111111111
11111111100000001211001100000000000000000111111111
11111111100011000000000011000000000000000111111111
11111111100000110000000000000000000110000111111111
11111111100000000000000000000000000001100111111111
11111111100000000000000000000000000000000111111111
11111111101100000000000000000000000000000111111111
11111111100000000100000000000000000001111111111111
11111111100000000000011110000000000001111111111111
11111111100110000000012110000000000000000111111111
11111111100000000000000000000000000000000111111111
11111111100000011000000000000000000000000111111111
11111111100000000000000000000000000000000111111111
11111111111111111111111111111111111111111111111111
11111111111111111111111111111111111111111111111111
11111111111111111111111111111111111111111111111111
11111111111111111111111111111111111111111111111111
11111111111111111111111111111111111111111111111111